NO ./path_to_the_north_texture
EA ./path_to_the_east_texture
SO ./path_to_the_south_texture
WE ./path_to_the_west_texture


F 100,230,100
C 165,190,240

111111111111
111000100001
11000000N011
101100010001
111111111111
