EA ./textures/wall/east.xpm
NO ./textures/wall/north.xpm
SO ./textures/wall/south.xpm
WE ./textures/wall/west.xpm

F 90,240,130
C 245,120,230

        1111111111111111111111111
        1000000000110000000000001
        1011000001110000000000001
        10010E0000000000000000001
111111111011000001110000000000001
100000000011000001110111110111111
11110111111111011100000010001
11111111111111111111111111111
                      
11111111111111111111111111111
11000000110101011100001000001
10000000000000001100000010001
10000000000000001101000010001
1100000111010101111101111000011
11110111 1110101 101110010001
11111111 1111111 111111111111
